25 23
 03 07 07 07 07 07 07 07 07 07 07 11 07 07 07 07 07 07 07 07 11 07 05
 08 00 18 01 01 01 01 01 01 01 01 08 01 01 01 01 01 01 01 01 08 00 08
 09 07 14 01 01 01 13 07 07 14 01 16 01 13 07 07 14 01 01 01 16 17 08
 08 01 01 01 01 01 01 01 01 01 01 01 01 01 01 01 01 01 01 01 01 01 08
 08 02 13 07 14 01 01 01 13 07 07 11 07 07 14 01 01 01 13 07 14 02 08
 08 01 01 01 01 01 15 01 01 01 01 08 01 01 01 01 15 01 01 01 01 01 08
 04 07 07 07 05 01 08 01 01 01 01 08 01 01 01 01 08 01 03 07 07 07 06
 00 00 00 00 08 01 08 01 01 01 01 08 01 01 01 01 08 01 08 00 00 00 00
 00 00 00 00 08 01 09 07 07 14 01 16 01 13 07 07 10 01 08 00 00 00 00
 00 00 00 00 08 01 08 01 01 01 01 01 01 01 01 01 08 01 08 00 00 00 00
 00 00 00 00 08 01 08 01 01 03 07 07 07 05 01 01 08 01 08 00 00 00 00
 07 07 07 07 06 01 16 01 01 08 00 00 00 08 01 01 16 01 04 07 07 07 07
 01 01 01 01 01 01 01 01 01 08 00 00 00 08 01 01 01 01 01 01 01 01 01
 07 07 07 07 05 01 15 01 01 08 00 00 00 08 01 01 15 01 03 07 07 07 07
 00 00 00 00 08 01 08 01 01 04 07 07 07 06 01 01 08 01 08 00 00 00 00
 00 00 00 00 08 01 08 01 01 01 01 00 01 01 01 01 08 01 08 00 00 00 00
 00 00 00 00 08 01 09 07 07 14 01 15 01 13 07 07 10 01 08 00 00 00 00
 00 00 00 00 08 01 08 01 01 01 01 08 01 01 01 01 08 01 08 00 00 00 00
 03 07 07 07 06 01 08 01 01 01 01 08 01 01 01 01 08 01 04 07 07 07 05
 08 01 01 01 01 01 16 01 01 01 01 08 01 01 01 01 16 01 01 01 01 01 08
 08 02 13 07 14 01 01 01 13 07 07 12 07 07 14 01 01 01 13 07 14 02 08
 08 01 01 01 01 01 01 01 01 01 01 01 01 01 01 01 01 01 01 01 01 01 08
 08 17 15 01 01 01 13 07 07 14 01 15 01 13 07 07 14 01 01 01 13 07 10
 08 00 08 01 01 01 01 01 01 01 01 08 01 01 01 01 01 01 01 01 18 00 08
 04 07 12 07 07 07 07 07 07 07 07 12 07 07 07 07 07 07 07 07 07 07 06

سیاه: 00
نقطه کوچول: 01
نقطه گنده: 02
گوشه چپ بالا: 03
گوشه چپ پایین: 04
گوشه راست بالا: 05
گوشه راست پایین: 06
موازی افقی: 07
موازی عمودی: 08
میانه چپ: 09
میانه راست: 10
میانه بالا: 11
میانه پایین: 12
گرد چپ: 13
گرد راست: 14
گرد بالا: 15
گرد پایین: 16
خط افقی: 17
خط عمودی: 18